..........................................................................................................................................................................................................................................................
..........................................................................................................................................................................................................................................................
....................c..............C............................c................C................................c...............C...............................c...............C...................O....................N.......NNNNNNN......NNNNNNNNNN
............................+.........................c................+..............................c..................+.............................c..................+..............................c.................N....................NNNNNNNNNN
.............................................................................g.g...........................................................................................................................................N....................NNNNNNNNNN
......................?.....................................................BBBBBBBB....BBB?..............&...........BBB.....B??B.......................................................SS................................N........$$$$$.......NNNNNNNNNN
........................................................................................................................................................................................SSS................................N....................NNNNNNNNNN
.......................................................................................................................................................................................SSSS................................N.......$$$$$$$......NNNNNNNNNN
......................................................................................................................................................................................SSSSS................§...............N....................NNNNNNNNNN
................?...B&B?B...................P.........½..................B&B...............£.....BB....?..?..?.....B...........BB......S..S..........SS..S............BB?B...........SSSSSS................................N.......$$$$$$$......NNNNNNNNNN
.....................................P......p.........p...............................................................................SS..SS........SSS..SS.........................SSSSSSS................................N..1....NNNNNNN...1..NNNNNNNNNN
@...........................P........p......p.@.......p......................................@.......................................SSS..SSS.@....SSSS..SSS.....½..............P..SSSSSSSS....@...........................N..å....NNNNNNN...å..NNNNNNNNNN
...M......._....~......g....p........p..=g..p...g.g...p._...~.......-................._........gg......_k..~.....gg-......gg...gg...SSSS-.SSSS....SSSSS..SSSS.~..p..-.......g.g.p.SSSSSSSSS...........S........-..~........N..å....NNNNNNN...å..NNNNNNNNNN
GGGGGGGGGGGGGGGGGGGGGGGGGGGGGGGGGGGGGGGGGGGGGGGGGGGGGGGGGGGGGGGGG..GGGGGGGGGGGGGGG...GGGGGGGGGGGGGGGGGGGGGGGGGGGGGGGGGGGGGGGGGGGGGGGGGGGGGGGGGGGGGGGGGG..GGGGGGGGGGGGGGGGGGGGGGGGGGGGGGGGGGGGGGGGGGGGGGGGGGGGGGGGGGGGGGGG..HHHHHHHHHHHHHHHHHHHHHHHHHHHHHHH
GGGGGGGGGGGGGGGGGGGGGGGGGGGGGGGGGGGGGGGGGGGGGGGGGGGGGGGGGGGGGGGGG..GGGGGGGGGGGGGGG...GGGGGGGGGGGGGGGGGGGGGGGGGGGGGGGGGGGGGGGGGGGGGGGGGGGGGGGGGGGGGGGGGG..GGGGGGGGGGGGGGGGGGGGGGGGGGGGGGGGGGGGGGGGGGGGGGGGGGGGGGGGGGGGGGGG..HHHHHHHHHHHHHHHHHHHHHHHHHHHHHHH
