.........................................................................................................................................................................................................................
.........................................................................................................................................................................................................................
....................c..............C............................c................C................................c...............C...............................c...............C...................O..................
............................+.........................c................+..............................c..................+.............................c..................+..............................c...............
.........................................................................................................................................................................................................................
......................?.....................................................BBBBBBBB....BBB?..............?...........BBB.....B??B.......................................................SS..............................
........................................................................................................................................................................................SSS..............................
.......................................................................................................................................................................................SSSS..............................
......................................................................................................................................................................................SSSSS................§.............
................?...B^B?B...................P.........P..................B?B...............$.....BB....?..?..?.....B...........BB......S..S..........SS..S............BB?B...........SSSSSS..............................
.....................................P......p.........p...............................................................................SS..SS........SSS..SS.........................SSSSSSS..............................
@...........................P........p......p.@.......p......................................@.......................................SSS..SSS.@....SSSS..SSS.....P..............P..SSSSSSSS....@.........................
..........._....~......-....p........p..=...p.........p._...~.......-................._................._...~.......-...............SSSS-.SSSS....SSSSS..SSSS.~..p..-...........p.SSSSSSSSS...........S........-..~......
GGGGGGGGGGGGGGGGGGGGGGGGGGGGGGGGGGGGGGGGGGGGGGGGGGGGGGGGGGGGGGGGG..GGGGGGGGGGGGGGG...GGGGGGGGGGGGGGGGGGGGGGGGGGGGGGGGGGGGGGGGGGGGGGGGGGGGGGGGGGGGGGGGGG..GGGGGGGGGGGGGGGGGGGGGGGGGGGGGGGGGGGGGGGGGGGGGGGGGGGGGGGGGGGGGGGG
GGGGGGGGGGGGGGGGGGGGGGGGGGGGGGGGGGGGGGGGGGGGGGGGGGGGGGGGGGGGGGGGG..GGGGGGGGGGGGGGG...GGGGGGGGGGGGGGGGGGGGGGGGGGGGGGGGGGGGGGGGGGGGGGGGGGGGGGGGGGGGGGGGGG..GGGGGGGGGGGGGGGGGGGGGGGGGGGGGGGGGGGGGGGGGGGGGGGGGGGGGGGGGGGGGGGG
