.........................................................................................................................................................................................................................................................
....................................................................................................................................................................................l.................................C..................................
......C........GGGGGGGGGGN.....NNNNNNNNNNNNNNNNNNNNNNNNNNNNNNNNNNNNNNNNNNNNNNNNNNNNNNNNNNNNNNNNNNNNNNNNNNNNNNNNNNNNNNNNNNNNNNNNNNNNNNNNNNNNNNNNNNNNNNNNNNNNNNNNNNNNNNN........................NNNNNNNNNNNNNNNNNNNN.........................O.c............
............c..GGGGGGGGGGN..............................................................NN..NNNNNN..NNNN.....u.NNNN..................................................................................NNNNNNNNNNNNN........................................
...............GGGGGGGGGGN..............................................................NN..NNNNNN..NNNN.......NNNN..................................................................................NNNNNNNNNNNNN........................................
...............GGGGGGGGGGN................................................$$$$........NN........NN...N.....NN..........$$$$$$...........................................<..............<.............NNNNNNNNNNNNN............SS..........................
...............GGGGGGGGGGN............................................................NN........NN...N.....NN........................................................................................NNNNNNNNNNNNN...........SSS..........................
...............GGGGGGGGGGN.............................................N..NNNN..N.....NN........NN...N.....NN..........NNNNNN.........................................u...........................1..NNNNNNNNNNNNN..........SSSS..........................
#..............GGGGGGGGGGN..................................%..........N$$N..N$$N.....NN....$$$$NN...N.$¤..NN....uu....NNNNNN...............V.......................u........NNNNNN...............å..NNNNNNNNNNNNN.........SSSSS...............§..........
...............GGGGGGGGGGN.........|!!!!...........D..D................NNNN..NNNN.....NNNN..NNNNNN...NNNN..NN..NNNN....................V....Å.......................DD............................å..NNNNNNNNNNNNN........SSSSSS..........................
..........½....GGGGGGGGGGN..1...................D..D..D..D.....D........................NN.............................................Å....å..........NN..........DDD......................NNNNNNNNNNNNNNNNNNNNNN...v...SSSSSSS..........................
..........p....GGGGGGGGGGN..å................D..D..D..D..D.....D..D.....................NN.............................................å....å....Å.....NN.........DDDD......................NNNNNNNNNNNNNNNNNNNNNN...½..SSSSSSSS..@.......................
..M.......p....GGGGGGGGGGN..å..........u.uD..D..D..D..D..D...u.D..D..................l.l.........l..u...............................uuuå....å...uå.....NN........DDDDD..<..............<....NNNNNNNNNNNNNNNNNNNNNN...p.SSSSSSSSS...........S.......-..~...
GGGGGGGGGGGGGGGGGGGGGGGGGHHHHHHHHHHHHHHHHHHHHHHHHHHHHHHHHHHHHHHHHHHHHHHHHHHHHHHHHHHHHHHHHHHHHHHHHHHHHHHHHHHHHHHHHHH...HHHHHHHHHHHHHHHHHHHHHHHHHHHHHHH..HH..HHHHHHHHHHH.......HHHHHHHH.......HHHHHHHHHHHHHHHHHHHHHHGGGGGGGGGGGGGGGGGGGGGGGGGGGGGGGGGGGGGGGG
GGGGGGGGGGGGGGGGGGGGGGGGGHHHHHHHHHHHHHHHHHHHHHHHHHHHHHHHHHHHHHHHHHHHHHHHHHHHHHHHHHHHHHHHHHHHHHHHHHHHHHHHHHHHHHHHHHH...HHHHHHHHHHHHHHHHHHHHHHHHHHHHHHH..HH..HHHHHHHHHHH.......HHHHHHHH.......HHHHHHHHHHHHHHHHHHHHHHGGGGGGGGGGGGGGGGGGGGGGGGGGGGGGGGGGGGGGGG
